XXXXXXXXXX
XXX.....XX
XXX.....XX
X.......XX
X.......XX
X.......XX
XXXXX...XX
XXXXX...XX
XXXXXXXXXX
XXXXXXXXXX