..........
...#####..
...#...#..
.###...#..
.#.....#..
.#####.#..
.....#.#..
.....###..
..........
..........