##################################################
#..O...OOO..O..O..O.O.OOOO.#OO...O.O.......OO....#
#O...OO#..#.#O...OOOO...O#O..O#.O..OO...O.O......#
#..OO......OO....#O...OO...O...#O........O......O#
##..#..OOO..O.....OO....##......OO..O.....O.O..O.#
#..O#.O.O..O..O.#OOOO...OO......#OO..OO..#.OOO...#
#O.....O.OOO....O....O#.....O.#....#........O.O..#
#...O....O.OO..O#..#O.#..O...........O#.....#O..O#
#....O....OO.O.##.......#....O.O.O.O.O..#O...O...#
#O......#..OO.....O...OO.OOO.#.O#.#..OO.....#.O.O#
#O....O.#O..O..O...O#.OO..O.........OOO..O...OOO.#
#OO..O....#OOO...#.O..#.....O#O#..#.......O..OO.##
#..O.O.......#O...#.#O..O#.O.O.OO...O......O.....#
#....O...O##.....O..OO#..#O..O.....O...O.#.#O....#
#...#.OO#.O.........O.....O..O.O#O#.....OO.O....##
#..#...OO.O#OOO..O.#..........O.......O..##O...O##
#.O..O.OO#.....OO.O.O....O.#.....O#OO..OOO.##....#
#O...OO#O......O...#.O....O...O.#......OO..O.O...#
#.#..O.......O..OO....OOOO...O#...O....#.O.O.....#
#...OO.OO..OO....OO...........#.O#...O#.O.O#.OO.##
#O....O..#O.....O#.......#.O....O.....O....O.O..O#
##..O..O.O..#..O#......O......O..O#...#.O..O...#O#
#OO..OO.O..OO....OO.O#.OO.O.O#OO.#.OOOO...#.OO#..#
#.#O.O..OO.O....O...O...O.......#O..#O#.........##
#O.#O..#.O....#.#O.O.O..@..O.......O#.O...#..O...#
#O...O..#.#..O.OO....O.....O.O#....O..O.O#.OO..O.#
#....O.....O#..O....#......O.O.#..OO#OOO.O#.....O#
#O.#.O..#O#.....OO.O..O......#O...O...OO.....O...#
##O.O.O....OO.OOOOO..O..#.....O#OO.......OO....#.#
#.OO..O#.OO.......OOO#.O..O.OO.O..OO...O...O..O#.#
#O.#O..#O..O...O...O..O..O..O.....OO..O..O.....OO#
#O......O...O.OO..O.#..O..OO..OO...OOO.O.......O.#
#.OO....#....OO........O..O...OOO...O.O...O#..O..#
#..O....#..OO.O.OO..O#OO...#..O...#....O.....O..O#
#O...O#O.O..OO.#O.OOO.#.O..O#.O.......OO.......O##
#..##...O..O...#O.OOO.OO.#....O..O.O.O...##O...O.#
###......#.OO#.....O.O......O#.O...OO......O..O#.#
#.O.......O#OO#.O.O..#.....OOO....#.....OOO.OO..O#
#.O.#....O....#...O.....O....#....O............O.#
#OO.O..OO..OO...O.O.....O.##O..............O....O#
#....O..OO.O..O.......OOO..O..#..#OOO.O.O....OO..#
#O..O#..O#.#...O......O..O..O.O.#....O....OO#..OO#
#...OO........#.........O........O..O.....O......#
#O..OOO..O...O.O.OO#O#..O##..#OOO.O.OO..O..O...O.#
#.....#..#.O.....O....O#OO....O..O......#........#
#.......O.O....O.OO.#..O#....#.O..O..OO..OO#O...##
#..OO..O..O..O..#OO.OOO.....#.O.O..O.OOO..#O.....#
#O.OOO.#..OO...O......O.#.O...#...O..O......OO...#
#..OOOO.O#..........#.OOO......#....OO..OO..O.O..#
##################################################
